NO ./img/WALL.xpm
SO ./img/STONE2.xpm
WE img/STONE3.xpm
EA img/SP_HOT1.xpm

F 126,81,9
C 133,193,233 

00100000000000000010000
001000000000000000 0000
11111111111011111111111
  100000000000000010000
  100000000000000010000
  100000000000000010000
  100000000000000010000
  100000000000000010
  1000000000N0000010
  100000000000000010
11111111111111111111111
00100000000000000010000
00100000000000000010000
