NO ./path_to_the_north_texture
SO ./path_to_the_south_texture
WE ./path_to_the_west_texture
EA ./path_to_the_east_texture
F 126,81,9
C 133,193,233 

111111111111111111111111111111111
100000000000000000000000000000001
100000000000000000000000000000001
100000000000000000000000000000001
100000000000000000000000000000001
100000000000010000000000000000001
100000000000000000000000000000001
100000000000000000000000000000001
100000000000000000000000000000001
10000000000000000000000000000000111
100000000000000000001000000000001
100000000000000000000000000000001
100000000000000000000000000000001
10000000000000000000000000000000111111111111111111111111111
10000000000000000000000000000000000000000000000000000000001
10000000010000000000000000000000000000000000000000000000001
10000000000000000000001111000000000000000000000000000000001
10000000000000000000000000000000000000000000000100000000001
10000000000000000000000000000000000000000000000000000000001
100000000000000N0000000000000000000000000000000000000000001
10000000000000000000000000000000111111111111111111111111111
111111111111111111111111111111111
       1
