

WE img/STONE3.xpm

EA img/SP_HOT1.xpm

NO ./img/WALL.xpm

SO ./img/STONE2.xpm

F 126,81,9
C 133,193,233 

111111111111111111111111111111111
100000000000000000000000000000001
100000000000000000000000000000001
100000000000000000000000000000001
100000000000000000000000000000001
100000000000000000000000000000001
100000000000000010000000000000001
100000000000000000000000000000001
100000000000000000000000000000001
100000000000000000000000000000001
100000000000000000010000000000001
100000000000010N00010000000000001
100000000000000000000000000000001
100000000000000000000000000000001
100000000000000000000000000000001
100000000000000000000000000000001
100000000000000000000010000000001
100000000000000000000000000000001
100000000000000000000000000000001
100000010000000000000000000000001
100000000000000000000000000000001
111111111111111111111111111111111
