NO ./path_to_the_north_texture
SO ./path_to_the_south_texture
WE ./path_to_the_west_texture
EA ./path_to_the_east_texture
F 126,81,9
C 133,193,233 

00100000000000000010000
00100000000000000010000
11111111111111111111111
00100000000000000010000
00100000000000000010000
00100000000000000010000
00100000000000000010000
00100000000000000010000
001000000000N0000010000
00100000000000000010000
11111111111111111111111
00100000000000000010000
00100000000000000010000
