

WE img/STONE3.xpm

EA img/SP_HOT1.xpm

NO ./img/WALL.xpm

SO ./img/STONE2.xpm

F 126,81,9

C 133,193,233 

00100000000000000010000
00100000000000000010000
11111111111111111111111
00100000000000000010000
00100000000000000010000
00100000000000000010000
00100000000000000010000
00100000000000000010000
001000000000N0000010000
00100000000000000010000
11111111111111111111111
00100000000000000010000
00100000000000000010000
